11111111111111111111
10000000000000000001
10000000000000000001
10000000000000000001
10000000000000000001
10000000000000000081
10000000000000000021
10000500000000000211
10060000400400702111
11111111111111111111