11111111111111111111
10000000000000000001
10000000000000000001
10000000000000000001
10000000000000000001
10000000000000000081
10000001110000000021
10000500000000000211
10000000400400702111
11111111111111111111